###########
# #       #
# ##### ###
# # # #   #
# # # ### #
# #       #
# ### # ###
#     #   #
# # ### ###
# #   #   #
###########
