###########
#         #
# # ### ###
# #   #   #
# ####### #
#   #   # #
####### # #
#   #   # #
### # # # #
#     #   #
###########
