###########
#   #     #
# ### # # #
#     # # #
# # ##### #
# #     # #
# ####### #
# # # #   #
### # # # #
#       # #
###########
