#####################
#     #             #
##### # ### ####### #
#     # #   #     # #
# ####### ### ##### #
# #       # #       #
# # ### ### # #######
# #   # #   #     # #
# ### # ### ##### # #
# #   #   #     # # #
# ####### # ##### # #
#   #   # # #   #   #
### # # # # # # ### #
# #   # # # # #   # #
# ##### # # # # ### #
#     #   # # #     #
# ######### # #######
# #     #     #     #
# # ### # ##### ### #
#     #         #   #
#####################
