###########
#   # #   #
# ### # ###
#         #
# ### # ###
# # # #   #
### # ### #
#   # #   #
# ### ### #
#       # #
###########
