###########
#     #   #
### # ### #
# # # #   #
# ### ### #
#       # #
####### # #
# # #     #
# # # # ###
#     #   #
###########
