###########
# # #   # #
# # # # # #
#     # # #
### # # # #
# # # #   #
# # #######
#     #   #
### # # ###
#   #     #
###########
