###########
#.  #.....#
#.###.# # #
#.....# # #
# # ##### #
# #     # #
# ####### #
# # # #   #
### # # # #
#       # #
###########
