###########
#O  # #   #
#.### # ###
#.......  #
# ### #.###
# # # #...#
### # ###.#
#   # #  .#
# ### ###.#
#       #X#
###########
